"a" = (/turf/open/floor/plating/vampgrass,/area/space)
"i" = (/turf/open/floor/plating/sidewalk/poor,/area/space)
"j" = (/obj/machinery/light{dir = 1},/turf/open/floor/plating/sidewalk/poor,/area/space)
"m" = (/obj/manholedown,/turf/open/floor/plating/vampgrass,/area/space)
"n" = (/obj/structure/flora/ausbushes,/turf/open/floor/plating/vampgrass,/area/space)
"p" = (/obj/structure/flora/ausbushes/lavendergrass,/turf/open/floor/plating/vampgrass,/area/space)
"r" = (/obj/effect/decal/bordur,/obj/effect/decal/bordur{dir = 9; icon_state = "border"},/turf/open/floor/plating/sidewalk/poor,/area/space)
"t" = (/obj/structure/flora/ausbushes/sparsegrass,/turf/open/floor/plating/vampgrass,/area/space)
"u" = (/obj/structure/flora/ausbushes/fullgrass,/turf/open/floor/plating/vampgrass,/area/space)
"v" = (/turf/closed/wall/vampwall,/area/space)
"w" = (/obj/structure/flora/ausbushes/lavendergrass,/obj/structure/big_vamprocks,/turf/open/floor/plating/vampgrass,/area/space)
"x" = (/obj/effect/decal/bordur{dir = 1; icon_state = "border"},/turf/open/floor/plating/sidewalk/poor,/area/space)
"D" = (/obj/structure/vampfence/rich{dir = 4; icon_state = "fence"},/turf/open/floor/plating/vampgrass,/area/space)
"E" = (/obj/machinery/light{pixel_y = 32},/turf/open/floor/plating/sidewalk/poor,/area/space)
"G" = (/obj/effect/decal/bordur{dir = 1; icon_state = "border"},/obj/effect/decal/bordur{dir = 10},/turf/open/floor/plating/sidewalk/poor,/area/space)
"H" = (/obj/structure/flora/ausbushes/sparsegrass,/obj/structure/big_vamprocks,/turf/open/floor/plating/vampgrass,/area/space)
"J" = (/obj/effect/decal/graffiti,/turf/open/floor/plating/sidewalk/poor,/area/space)
"K" = (/obj/structure/big_vamprocks,/turf/open/floor/plating/vampgrass,/area/space)
"L" = (/obj/structure/vamprocks,/turf/open/floor/plating/vampgrass,/area/space)
"M" = (/turf/open/floor/plating/asphalt,/area/space)
"O" = (/obj/structure/vamptree/pine,/turf/open/floor/plating/vampgrass,/area/space)
"P" = (/obj/effect/decal/bordur,/turf/open/floor/plating/sidewalk/poor,/area/space)
"R" = (/obj/structure/flora/ausbushes/lavendergrass,/obj/structure/small_vamprocks,/turf/open/floor/plating/vampgrass,/area/space)
"S" = (/turf/closed/wall/vampwall/rock,/area/space)
"T" = (/obj/structure/small_vamprocks,/turf/open/floor/plating/vampgrass,/area/space)
"Y" = (/obj/effect/decal/bordur,/obj/effect/decal/bordur{dir = 1},/turf/open/floor/plating/sidewalk/poor,/area/space)
"Z" = (/obj/effect/decal/bordur{dir = 1; icon_state = "border"},/obj/effect/decal/bordur,/turf/open/floor/plating/sidewalk/poor,/area/space)

(1,1,1) = {"
aSSSSSSSSSSSSaaaaaaaaaaaaaaaaaaaaaaaaaaaaaaaaaaaaaaaaaaaaaaaaaaaaaaaaaaaaaaaaaaaaaaaaaaaaa
aSaaaaaaaaaaSSaaaaaaaaSSSSSaaaSSSSaaaaaaaaaaaaaaaaaaaaaaaaaaaaaaaaaaaaSSSaaaaaaaaaaaaaaaaa
aSaaaaaaaaaaaSaaaaaSSSSaaaSSSSSaaSSSaaaaaaaaaaaaSSSaSSSaaSSSaaSSSSaSSSSaSSSSSaaaaaaaaaaaaa
aSSaaaaaaaaaaSaaaSSSaaaaaaaaaaaaaaaSSaaaaSSSaaSSSaSSSaSSSSaSSSSaaSSSaaaaaaaaSSaaaaaaaaaaaa
aaSaaaaaaaaaaSSSSSaaaaaaaaaaaaaaaaaaSSaaSSaSSSSaaaaaaaaaaaaaaaaaaaaaaaaaaaaaaSSSaaaaaaaaaa
aaSaaaaaaaaaaaaaaaaaaaaaaaaaaaaaaaaanaaapaaanptaaaaaaaattaauaaantaauaaaaaaaaauaSaaaaaaaaaa
aaSSaaaaaaaaaaaaaaaaaaaaaaaaaaaaaaaaupppaauaaaaaauaataaaaatOaaaRaaapaaapaLaaaaaSSaaaaaaaaa
aaaSaaaaaaaaaaaaaaaaaaaaaaaaaaaaaaaaataaaaatOaaaRaatOauaataaaanaatapaaaawaauaaapSaaaaaaaaa
aaaSaaaaaaaaaaaaaaaaaaaaaaaaaaaaaaaatOauaataaaanaaaaaaaamaaaaaaaataauauaaaapaaapSaaaaaaaaa
aaSSaaaaaaaaaaaaaaaaaaaaaaaaaaaaaaaaaaaaaaaaaaaaaaOtapaaaaaauaOaaaaOaaaaatapaaaaSaaaaaaaaa
aaSaaaaaaaaaaaaaaaaaaaaaaaaaaaaaaaaOtapaaaaaauaOaaaaapaanaaaattanaaaTanaataauauaSSaaaaaaaa
aaSaaaaaaaaaaaaaaaaaaaaaaaaaaaaaaaaaaapaanaaaattanaaaauauTaaTaaaaapaaTaaaaaOaaaaaSaaaaaaaa
aaSaaaaaaaaaaaaaaaaaaaaaaaaaaaaaaaaaaaauauTaaTaaaaaaaaaaaaLKaapaaaaaOappnaaaTanaaSSaaaaaaa
aSSaaaaaaaaaaaaaaaaaaaaaaaaaaaaaaaaauaaaaaaLKaapaaaaaaaaOaauaaaaapaauaapaapaaTaaaaSaaaaaaa
aSaaaaaaaaaaaaaaaaaaaaaaaaaaaaaaaaataaaaatOaaaaaaaaaaauaaaaaaOauaaaaaaapaaaaOappaSSaaaaaaa
aSSaaaaaaaaaaaaaaaaaaaaaaaaaaaaaaaaOauaataaaanOauaaaaaaaaattapaaaataaaaaapaauaapaSaaaaaaaa
aaSaaanaaapaaanptaaaaaaaattaauaaantaaaaaaaaaaapaaaaaaaaOapataaaaOaattaauaaaaaaapSSaaaaaaaa
aaSSaaupppaauaaaaaauaataaaaatOaaaRaapaaaaaauaOaaaOaaaTnaaaaaaauaaaaaatataataaaaaSaaaaaaaaa
aaaSaaataaaaatOaaaRaatOauaataaaanaaapaanaaaattauaaaaaaanuaaaOauaauaaaaaaOaattaauaaaaaaaaaa
aaaSaatOauaataaaanaaaaaaaamaaaaaaaaaauauTaaTaaauaaaaataTaapaaLaTaaaaOaaaaaaaatatSaaaaaaaaa
aaSSaaaaaaaaaaaaaaaaOtapaaaaaauaOaaaaaaaaLKaapLaTaaataKaaaaaaaKaaapaaaaaauaaaaaaSSSaaaaaaa
aaSaaOtapaaaaaauaOaaaaapaanaaaattanaaaaOaauaaaaKaaaaaaLauaauuaaapaaaauuaaaaaOaaaaaSaaaaaaa
aaSSaaaapaanaaaattanaaaauauTaaTaaaaaauaaaaaaOaaaapaaaaaaaaOaaaaTatataauaaapaaaaaaaSSaaaaaa
aaaSaaaaauauTaaTaaaaaaaaaaaaLKaapaaaaaaaattapaaaTaaaaauuaaaanattaaaOaTuapaaaauuaaaaSaaaaaa
aaaSaauaaaaaaLKaapaaaaaaaaOaauaaaaaaaaOapataaaattaaaatOuaataaaaauaaRaaaaatataauaaaaSaaaaaa
aaaSStaaaaatOaaaaaaaaaaauaaaaaaOauaaTnaaaaaaauaaauaaaaaaataaTaOaaanaHLaaaaaOaTuaaaSSaaaaaa
aaaaSOauaataaaanOauaaaaaaaaattapaaaaaanuaaaOauaOaaaaataaataatauuaaaataaauaaRaaaaaaSaaaaaaa
aaaSSaaaaaaaaaaapaaaaaaaaOapataaaaOataTaapaaLaauuaaaataaaaaaaaaaataaTaOaaanaHLaaaSSaaaaaaa
aaaSaapaaaaaauaOaaaOaaaTnaaaaaaauaaaaaaaaaaaaaaaaaaaaaaaaaaaataaataatauuaaaataaaaSaaaaaaaa
aaSSaapaanaaaattauaaaaaaanuaaaOauaauaaaaaaOaattaauaaaaaaaaaaaaaaaaaaaaaaaaaaaaaaaSaaaaaaaa
aaSaaaauauTaaTaaauaaaaataTaapaaLaTaaaaOaaaaaaaatataaaaaaaaaaaaaaaaaaaaaaaaaaaaaaaSaaaaaaaa
aaSSaaaaaaaLKaapLaTaaataKaaaaaaaKaaapaaaaaauaaaaaaaaaaaaaaaaaaaaaaaaaaaaaaaaaaaaaSSaaaaaaa
aaaSSaaaaOaauaaaaKaaaaaaLauaauuaaapaaaauuaaaaaOaaaaaaaaaaaaaaaaaaaaaaaaaaaaaaaaaaaSaaaaaaa
aaaaSaauaaaaaaOaaaapaaaaaaaaOaaaaTatataauaaapaaaaaaaaaaaaaaaaaaaaaaaaaaaaaaaaaaaaaSaaaaaaa
aaaSSaaaaaattapaaaTaaaaauuaaaanattaaaOaTuapaaaauuaaaaaaaaaaaaaaaaaaaaaaaaaaaaaaaaaSaaaaaaa
aaaSaaaaOapataaaattaaaatOuaataaaaauaaRaaaaatataauaaaaaaaaaaaaaaaaaaaaaaaaaaaaaaaaSSaaaaaaa
aaSSaaTnaaaaaaauaaauaaaaaaataaTaOaaanaHLaaaaaOaTuaaaaaaaaaaaaaaaaaaaaaaaaaaaaaaaaSaaaaaaaa
aaSaaaaanuaaaOauaOaaaaataaataatauuaaaataaauaaRaaaaaaaaaaaaaaaaaaaaaaaaaaaaaaaaaaaSSaaaaaaa
aSSaaataTaapaaLaauuaaaataaaaaaaaaaataaTaOaaanaHLaaaaaaaaaaaaaaaaaaaaaaaaaaaaaaaaaaSSaaaaaa
aSaaaaaaaaaaaaaaaaaaaaaaaaaaaaataaataatauuaaaataaaaaaaaaaaaaaaaaaaaaaaaaaaaaaaaaaaSaaaaaaa
aSaaaaaaaaaaaaaaaaaaaaaaaaaaaaaaaaaaaaaaaaaaaaaaaaaaaaaaaaaaaaaaaaaaaaaaaaaaaaaaaaSaaaaaaa
aSaaaaaaaaaaaaaaaaaaaaaaaaaaaaaaaaaaaaaaaaaaaaaaaaaaaaaaaaaaaaaaaaaaaaaaaaaaaaaaaaSaaaaaaa
aSSaaaaaaaaaaaaaaaaaaaaaaaaaaaaaaaaaaaaaaaaaaaaaaaaaaaaaaaaaaaaaaaaaaaaaaaaaaaaaaaSaaaaaaa
aaSSaaaaaaaaaaaaaaaaaaaaaaaaaaaaaaaaaaaaaaaaaaaaaaaaaaaaaaaaaaaaaaaaaaaaaaaaaaaaaaSSaaaaaa
aaaSvDDDDDDDDDDDDDDDDDDDDDDDDDDDDDDDDDDDDDDDDDDDDDDDDDDDDDDDDDDDDDDDDDDDDDDDDDDDDDvSaaaaaa
aaaSaaaaaaaaaaaaaaaaaaaaaaaaaaaaaaaaaaaaaaaaaaaaaaaaaaaaaaaaaaaaaaaaaaaaaaaaaaaaaaaSSaaaaa
aaaSSaaaaaaaaaaaaaaaaaaaaaaaaaaaaaaaaaaaaaaaaaaaaaaaaaaaaaaaaaaaaaaaaaaaaaaaaaaaaaaaSaaaaa
aaSSaaaaaaaaaaaaaaaaaaaaaaaaaaaaaaaaaaaaaaaaaaaaaaaaaaaaaaaaaaaaaaaaaaaaaaaaaaaaaaaaSaaaaa
aaSaaaaaaaaaaaaaaaaaaaaaaaaaaaaaaaaaaaaaaaaaaaaaaaaaaaaaaaaaaaaaaaaaaaaaaaaaaaaaaaaaSSaaaa
aaSSaaaaaaaaaaaaaaaaaaaaaaaaaaaaaaaaaaaaaaaaaaaaaaaaaaaaaaaaaaaaaaaaaaaaaaaaaaaaaaaaaSaaaa
aaaSaaaaaaaaaaaaaaaaaaaaaaaaaaaaaaaaaaaaaaaaaaaaaaaaaaaaaaaaaaaaaaaaaaaaaaaaaaaaaaaaaSaaaa
vvvvaaaaaaaaaaaaaaaaaaaaaaaaaaaaaaaaaaaaaaaaaaaaaaaaaaaaaaaaaaaaaaaaaaaaaaaaaaaaaaaaavvvvv
iJEvaaaaaaaaaaaaaaaaaaaaaaaaaaaaaaaaaaaaaaaaaaaaaaaaaaaaaaaaaaaaaaaaaaaaaaaaaaaaaaaaavEiJJ
PPPPYYYYYYYYYYYYYYYYYYYYYYYYYYYYYYYYYYYYYYYYYYYYYYYYYYYYYYYYYYYYYYYYYYYYYYYYYYYYYYYYYrPPPP
MMMMMMMMMMMMMMMMMMMMMMMMMMMMMMMMMMMMMMMMMMMMMMMMMMMMMMMMMMMMMMMMMMMMMMMMMMMMMMMMMMMMMMMMMM
MMMMMMMMMMMMMMMMMMMMMMMMMMMMMMMMMMMMMMMMMMMMMMMMMMMMMMMMMMMMMMMMMMMMMMMMMMMMMMMMMMMMMMMMMM
xxxxZZZZZZZZZZZZZZZZZZZZZZZZZZZZZZZZZZZZZZZZZZZZZZZZZZZZZZZZZZZZZZZZZZZZZZZZZZZZZZZZZGxxxx
iijvaaaaaaaaaaaaaaaaaaaaaaaaaaaaaaaaaaaaaaaaaaaaaaaaaaaaaaaaaaaaaaaaaaaaaaaaaaaaaaaaavjiii
vvvvaaaaaaaaaaaaaaaaaaaaaaaaaaaaaaaaaaaaaaaaaaaaaaaaaaaaaaaaaaaaaaaaaaaaaaaaaaaaaaaaavvvvv
aaaSaaaaaaaaaaaaaaaaaaaaaaaaaaaaaaaaaaaaaaaaaaaaaaaaaaaaaaaaaaaaaaaaaaaaaaaaaaaaaaaaaSaaaa
aaSSaaaaaaaaaaaaaaaaaaaaaaaaaaaaaaaaaaaaaaaaaaaaaaaaaaaaaaaaaaaaaaaaaaaaaaaaaaaaaaaaSSaaaa
aSSaaaaaaaaaaaaaaaaaaaaaaaaaaaaaaaaaaaaaaaaaaaaaaaaaaaaaaaaaaaaaaaaaaaaaaaaaaaaaaaaaSaaaaa
aSSaaaaaaaaaaaaaaaaaaaaaaaaaaaaaaaaaaaaaaaaaaaaaaaaaaaaaaaaaaaaaaaaaaaaaaaaaaaaaaaaSSaaaaa
aSaaaaaaaaaaaaaaaaaaaaaaaaaaaaaaaaaaaaaaaaaaaaaaaaaaaaaaaaaaaaaaaaaaaaaaaaaaaaaaaaaaSaaaaa
aSaaaaaaaaaaaaaaaaaaaaaaaaaaaaaaaaaaaaaaaaaaaaaaaaaaaaaaaaaaaaaaaaaaaaaaaaaaaaaaaaaaSaaaaa
aSSaaaaaaaaaaaaaaaaaaaaaaaaaaaaaaaaaaaaaaaaaaaaaaaaaaaaaaaaaaaaaaaaaaaaaaaaaaaaaaaaaSSaaaa
aaSaaaaaaaaaaaaaaaaaaaaaaaaaaaaaaaaaaaaaaaaaaaaaaaaaaaaaaaaaaaaaaaaaaaaaaaaaaaaaaaaaaSaaaa
aSSaaaaaaaaaaaaaaaaaaaaaaaaaaaaaaaaaaaaaaaaaaaaaaaaaaaaaaaaaaaaaaaaaaaaaaaaaaaaaaaaaaSaaaa
aSaaaaaaaaaaaaaaaaaaaaaaaaaaaaaaaaaaaaaaaaaaaaaaaaaaaaaaaaaaaaaaaaaaaaaaaaaaaaaaaaaaSSaaaa
aSSaaaaaaaaaaaaaaaaaaaaaaaaaaaaaaaaaaaaaaaaaaaaaaaaaaaaaaaaaaaaaaaaaaaaaaaaaaaaaaaaaSaaaaa
aaSaaaaaaaaaaaaaaaaaaaaaaaaaaaaaaaaaaaaaaaaaaaaaaaaaaaaaaaaaaaaaaaaaaaaaaaaaaaaaaaaaSaaaaa
aSSaaaaaaaaaaaaaaaaaaaaaaaaaaaaaaaaaaaaaaaaaaaaaaaaaaaaaaaaaaaaaaaaaaaaaaaaaaaaaaaaSSaaaaa
SSaaaaaaaaaaaaaaaaaaaaaaaaaaaaaaaaaaaaaaaaaaaaaaaaaaaaaaaaaaaaaaaaaaaaaaaaSSSSSSaaSSaaaaaa
SaaaaaaaaaaaaaaaaaaaaaaaaaaaaaaaaaaaaaaaaaaaaaaaaaaaaaaaaaaaaaaaaSSSSaaaSSSaaaaSSSSaaaaaaa
SSaaaaaaaaaaaaaaaaaaaaaaaaaaaaaaaaaaaaaaaaaaaaaaaaaaaaaaSSSSSSSSSSaaSSSSSaaaaaaaaaaaaaaaaa
aSaaaaaaaaaaaaaaaaaaaaaaaaaaaaaaaaaaaaaaaaaaaaaaaaaaaSSSSaaaaaaaaaaaaaaaaaaaaaaaaaaaaaaaaa
aSSaaaaaaaaaaaaaaaaaaaaaaaaaaaaaaaaaaaaaaaaaaaaaaaaaSSaaaaaaaaaaaaaaaaaaaaaaaaaaaaaaaaaaaa
aaSSaaaaaaaaaaaSSSSaaaaaaaaaaaaaaaaaaaaaaaaaaaaaaaaaaaaaaaaaaaaaaaaaaaaaaaaaaaaaaaaaaaaaaa
aaaSaaSSSSaSSSSSaaaaaaaaaaaaaaaaaaaaaaaaaaaaaaaaaaaaaaaaaaaaaaaaaaaaaaaaaaaaaaaaaaaaaaaaaa
aaaSSSSaaSSSaaaaaaaaaaaaaaaaaaaaaaaaaaaaaaaaaaaaaaaaaaaaaaaaaaaaaaaaaaaaaaaaaaaaaaaaaaaaaa
"}
