"a" = (/turf/open/floor/plating/vampgrass,/area/space)
"b" = (/obj/structure/flora/ausbushes/lavendergrass,/turf/open/floor/plating/vampgrass,/area/space)
"d" = (/obj/structure/big_vamprocks,/turf/open/floor/plating/vampgrass,/area/space)
"e" = (/obj/structure/vamptree/pine,/turf/open/floor/plating/vampgrass,/area/space)
"f" = (/obj/structure/vamprocks,/turf/open/floor/plating/vampgrass,/area/space)
"h" = (/turf/open/floor/plating/sidewalk/poor,/area/space)
"i" = (/obj/effect/decal/bordur{dir = 1; icon_state = "border"},/obj/effect/decal/bordur{dir = 10},/turf/open/floor/plating/sidewalk/poor,/area/space)
"k" = (/obj/effect/decal/bordur{dir = 1; icon_state = "border"},/turf/open/floor/plating/sidewalk/poor,/area/space)
"m" = (/obj/effect/decal/bordur,/turf/open/floor/plating/sidewalk/poor,/area/space)
"q" = (/turf/closed/wall/vampwall,/area/space)
"r" = (/turf/open/space/basic,/area/space)
"s" = (/obj/structure/vampfence/rich{dir = 4; icon_state = "fence"},/turf/open/floor/plating/vampgrass,/area/space)
"t" = (/turf/open/floor/plating/asphalt,/area/space)
"x" = (/obj/structure/flora/ausbushes/sparsegrass,/obj/structure/big_vamprocks,/turf/open/floor/plating/vampgrass,/area/space)
"y" = (/obj/effect/decal/bordur{dir = 1; icon_state = "border"},/obj/effect/decal/bordur,/turf/open/floor/plating/sidewalk/poor,/area/space)
"z" = (/obj/effect/decal/bordur,/obj/effect/decal/bordur{dir = 9; icon_state = "border"},/turf/open/floor/plating/sidewalk/poor,/area/space)
"A" = (/obj/machinery/light{pixel_y = 32},/turf/open/floor/plating/sidewalk/poor,/area/space)
"E" = (/obj/manholedown,/turf/open/floor/plating/vampgrass,/area/space)
"I" = (/obj/structure/small_vamprocks,/turf/open/floor/plating/vampgrass,/area/space)
"J" = (/obj/effect/decal/graffiti,/turf/open/floor/plating/sidewalk/poor,/area/space)
"K" = (/obj/structure/flora/ausbushes/sparsegrass,/turf/open/floor/plating/vampgrass,/area/space)
"M" = (/obj/structure/flora/ausbushes/lavendergrass,/obj/structure/small_vamprocks,/turf/open/floor/plating/vampgrass,/area/space)
"N" = (/obj/structure/flora/ausbushes,/turf/open/floor/plating/vampgrass,/area/space)
"R" = (/obj/machinery/light{dir = 1},/turf/open/floor/plating/sidewalk/poor,/area/space)
"S" = (/turf/closed/wall/vampwall/rock,/area/space)
"U" = (/obj/structure/flora/ausbushes/fullgrass,/turf/open/floor/plating/vampgrass,/area/space)
"V" = (/obj/structure/flora/ausbushes/lavendergrass,/obj/structure/big_vamprocks,/turf/open/floor/plating/vampgrass,/area/space)
"Z" = (/obj/effect/decal/bordur,/obj/effect/decal/bordur{dir = 1},/turf/open/floor/plating/sidewalk/poor,/area/space)

(1,1,1) = {"
aSSSSSSSSSSSSaaaaaaaaaaaaaaaaaaaaaaaaaaaaaaaaaaaaaaaaaaaaaaaaaaaaaaaaaaaaaaaaaaaaaaaaaaaaa
aSaaaaaaaaaaSSaaaaaaaaSSSSSaaaSSSSaaaaaaaaaaaaaaaaaaaaaaaaaaaaaaaaaaaaSSSaaaaaaaaaaaaaaaaa
aSaaaaaaaaaaaSaaaaaSSSSaaaSSSSSaaSSSaaaaaaaaaaaaSSSaSSSaaSSSaaSSSSaSSSSaSSSSSaaaaaaaaaaaaa
aSSaaaaaaaaaaSaaaSSSaaaaaaaaaaaaaaaSSaaaaSSSaaSSSaSSSaSSSSaSSSSaaSSSaaaaaaaaSSaaaaaaaaaaaa
aaSaaaaaaaaaaSSSSSaaaaaaaaaaaaaaaaaaSSaaSSaSSSSaaaaaaaaaaaaaaaaaaaaaaaaaaaaaaSSSaaaaaaaaaa
aaSaaaaaaaaaaaaaaaaaaaaaaaaaaaaaaaaaNaaabaaaNbKaaaaaaaaKKaaUaaaNKaaUaaaaaaaaaUaSaaaaaaaaaa
aaSSaaaaaaaaaaaaaaaaaaaaaaaaaaaaaaaaUbbbaaUaaaaaaUaaKaaaaaKeaaaMaaabaaabafaaaaaSSaaaaaaaaa
aaaSaaaaaaaaaaaaaaaaaaaaaaaaaaaaaaaaaKaaaaaKeaaaMaaKeaUaaKaaaaNaaKabaaaaVaaUaaabSaaaaaaaaa
aaaSaaaaaaaaaaaaaaaaaaaaaaaaaaaaaaaaKeaUaaKaaaaNaaaaaaaaEaaaaaaaaKaaUaUaaaabaaabSaaaaaaaaa
aaSSaaaaaaaaaaaaaaaaaaaaaaaaaaaaaaaaaaaaaaaaaaaaaaeKabaaaaaaUaeaaaaeaaaaaKabaaaaSaaaaaaaaa
aaSaaaaaaaaaaaaaaaaaaaaaaaaaaaaaaaaeKabaaaaaaUaeaaaaabaaNaaaaKKaNaaaIaNaaKaaUaUaSSaaaaaaaa
aaSaaaaaaaaaaaaaaaaaaaaaaaaaaaaaaaaaaabaaNaaaaKKaNaaaaUaUIaaIaaaaabaaIaaaaaeaaaaaSaaaaaaaa
aaSaaaaaaaaaaaaaaaaaaaaaaaaaaaaaaaaaaaaUaUIaaIaaaaaaaaaaaafdaabaaaaaeabbNaaaIaNaaSSaaaaaaa
aSSaaaaaaaaaaaaaaaaaaaaaaaaaaaaaaaaaUaaaaaafdaabaaaaaaaaeaaUaaaaabaaUaabaabaaIaaaaSaaaaaaa
aSaaaaaaaaaaaaaaaaaaaaaaaaaaaaaaaaaKaaaaaKeaaaaaaaaaaaUaaaaaaeaUaaaaaaabaaaaeabbaSSaaaaaaa
aSSaaaaaaaaaaaaaaaaaaaaaaaaaaaaaaaaeaUaaKaaaaNeaUaaaaaaaaaKKabaaaaKaaaaaabaaUaabaSaaaaaaaa
aaSaaaNaaabaaaNbKaaaaaaaaKKaaUaaaNKaaaaaaaaaaabaaaaaaaaeabaKaaaaeaaKKaaUaaaaaaabSSaaaaaaaa
aaSSaaUbbbaaUaaaaaaUaaKaaaaaKeaaaMaabaaaaaaUaeaaaeaaaINaaaaaaaUaaaaaaKaKaaKaaaaaSaaaaaaaaa
aaaSaaaKaaaaaKeaaaMaaKeaUaaKaaaaNaaabaaNaaaaKKaUaaaaaaaNUaaaeaUaaUaaaaaaeaaKKaaUaaaaaaaaaa
aaaSaaKeaUaaKaaaaNaaaaaaaaEaaaaaaaaaaUaUIaaIaaaUaaaaaKaIaabaafaIaaaaeaaaaaaaaKaKSaaaaaaaaa
aaSSaaaaaaaaaaaaaaaaeKabaaaaaaUaeaaaaaaaafdaabfaIaaaKadaaaaaaadaaabaaaaaaUaaaaaaSSSaaaaaaa
aaSaaeKabaaaaaaUaeaaaaabaaNaaaaKKaNaaaaeaaUaaaadaaaaaafaUaaUUaaabaaaaUUaaaaaeaaaaaSaaaaaaa
aaSSaaaabaaNaaaaKKaNaaaaUaUIaaIaaaaaaUaaaaaaeaaaabaaaaaaaaeaaaaIaKaKaaUaaabaaaaaaaSSaaaaaa
aaaSaaaaaUaUIaaIaaaaaaaaaaaafdaabaaaaaaaaKKabaaaIaaaaaUUaaaaNaKKaaaeaIUabaaaaUUaaaaSaaaaaa
aaaSaaUaaaaaafdaabaaaaaaaaeaaUaaaaaaaaeabaKaaaaKKaaaaKeUaaKaaaaaUaaMaaaaaKaKaaUaaaaSaaaaaa
aaaSSKaaaaaKeaaaaaaaaaaaUaaaaaaeaUaaINaaaaaaaUaaaUaaaaaaaKaaIaeaaaNaxfaaaaaeaIUaaaSSaaaaaa
aaaaSeaUaaKaaaaNeaUaaaaaaaaaKKabaaaaaaNUaaaeaUaeaaaaaKaaaKaaKaUUaaaaKaaaUaaMaaaaaaSaaaaaaa
aaaSSaaaaaaaaaaabaaaaaaaaeabaKaaaaeaKaIaabaafaaUUaaaaKaaaaaaaaaaaKaaIaeaaaNaxfaaaSSaaaaaaa
aaaSaabaaaaaaUaeaaaeaaaINaaaaaaaUaaaaaaaaaaaaaaaaaaaaaaaaaaaaKaaaKaaKaUUaaaaKaaaaSaaaaaaaa
aaSSaabaaNaaaaKKaUaaaaaaaNUaaaeaUaaUaaaaaaeaaKKaaUaaaaaaaaaaaaaaaaaaaaaaaaaaaaaaaSaaaaaaaa
aaSaaaaUaUIaaIaaaUaaaaaKaIaabaafaIaaaaeaaaaaaaaKaKaaaaaaaaaaaaaaaaaaaaaaaaaaaaaaaSaaaaaaaa
aaSSaaaaaaafdaabfaIaaaKadaaaaaaadaaabaaaaaaUaaaaaaaaaaaaaaaaaaaaaaaaaaaaaaaaaaaaaSSaaaaaaa
aaaSSaaaaeaaUaaaadaaaaaafaUaaUUaaabaaaaUUaaaaaeaaaaaaaaaaaaaaaaaaaaaaaaaaaaaaaaaaaSaaaaaaa
aaaaSaaUaaaaaaeaaaabaaaaaaaaeaaaaIaKaKaaUaaabaaaaaaaaaaaaaaaaaaaaaaaaaaaaaaaaaaaaaSaaaaaaa
aaaSSaaaaaaKKabaaaIaaaaaUUaaaaNaKKaaaeaIUabaaaaUUaaaaaaaaaaaaaaaaaaaaaaaaaaaaaaaaaSaaaaaaa
aaaSaaaaeabaKaaaaKKaaaaKeUaaKaaaaaUaaMaaaaaKaKaaUaaaaaaaaaaaaaaaaaaaaaaaaaaaaaaaaSSaaaaaaa
aaSSaaINaaaaaaaUaaaUaaaaaaaKaaIaeaaaNaxfaaaaaeaIUaaaaaaaaaaaaaaaaaaaaaaaaaaaaaaaaSaaaaaaaa
aaSaaaaaNUaaaeaUaeaaaaaKaaaKaaKaUUaaaaKaaaUaaMaaaaaaaaaaaaaaaaaaaaaaaaaaaaaaaaaaaSSaaaaaaa
aSSaaaKaIaabaafaaUUaaaaKaaaaaaaaaaaKaaIaeaaaNaxfaaaaaaaaaaaaaaaaaaaaaaaaaaaaaaaaaaSSaaaaaa
aSaaaaaaaaaaaaaaaaaaaaaaaaaaaaaKaaaKaaKaUUaaaaKaaaaaaaaaaaaaaaaaaaaaaaaaaaaaaaaaaaSaaaaaaa
aSaaaaaaaaaaaaaaaaaaaaaaaaaaaaaaaaaaaaaaaaaaaaaaaaaaaaaaaaaaaaaaaaaaaaaaaaaaaaaaaaSaaaaaaa
aSaaaaaaaaaaaaaaaaaaaaaaaaaaaaaaaaaaaaaaaaaaaaaaaaaaaaaaaaaaaaaaaaaaaaaaaaaaaaaaaaSaaaaaaa
aSSaaaaaaaaaaaaaaaaaaaaaaaaaaaaaaaaaaaaaaaaaaaaaaaaaaaaaaaaaaaaaaaaaaaaaaaaaaaaaaaSaaaaaaa
aaSSaaaaaaaaaaaaaaaaaaaaaaaaaaaaaaaaaaaaaaaaaaaaaaaaaaaaaaaaaaaaaaaaaaaaaaaaaaaaaaSSaaaaaa
aaaSqsssssssssssssssssssssssssssssssssssssssssssssssssssssssssssssssssssssssssssssqSaaaaaa
aaaSaaaaaaaaaaaaaaaaaaaaaaaaaaaaaaaaaaaaaaaaaaaaaaaaaaaaaaaaaaaaaaaaaaaaaaaaaaaaaaaSSaaaaa
aaaSSaaaaaaaaaaaaaaaaaaaaaaaaaaaaaaaaaaaaaaaaaaaaaaaaaaaaaaaaaaaaaaaaaaaaaaaaaaaaaaaSaaaaa
aaSSaaaaaaaaaaaaaaaaaaaaaaaaaaaaaaaaaaaaaaaaaaaaaaaaaaaaaaaaaaaaaaaaaaaaaaaaaaaaaaaaSaaaaa
aaSaaaaaaaaaaaaaaaaaaaaaaaaaaaaaaaaaaaaaaaaaaaaaaaaaaaaaaaaaaaaaaaaaaaaaaaaaaaaaaaaaSSaaaa
aaSSaaaaaaaaaaaaaaaaaaaaaaaaaaaaaaaaaaaaaaaaaaaaaaaaaaaaaaaaaaaaaaaaaaaaaaaaaaaaaaaaaSaaaa
aaaSaaaaaaaaaaaaaaaaaaaaaaaaaaaaaaaaaaaaaaaaaaaaaaaaaaaaaaaaaaaaaaaaaaaaaaaaaaaaaaaaaSaaaa
qqqqaaaaaaaaaaaaaaaaaaaaaaaaaaaaaaaaaaaaaaaaaaaaaaaaaaaaaaaaaaaaaaaaaaaaaaaaaaaaaaaaaqqqqq
hJAqaaaaaaaaaaaaaaaaaaaaaaaaaaaaaaaaaaaaaaaaaaaaaaaaaaaaaaaaaaaaaaaaaaaaaaaaaaaaaaaaaqAhJJ
mmmmZZZZZZZZZZZZZZZZZZZZZZZZZZZZZZZZZZZZZZZZZZZZZZZZZZZZZZZZZZZZZZZZZZZZZZZZZZZZZZZZZzmmmm
tttttttttttttttttttttttttttttttttttttttttttttttttttttttttttttttttttttttttttttttttttttttttt
tttttttttttttttttttttttttttttttttttttttttttttttttttttttttttttttttttttttttttttttttttttttttt
kkkkyyyyyyyyyyyyyyyyyyyyyyyyyyyyyyyyyyyyyyyyyyyyyyyyyyyyyyyyyyyyyyyyyyyyyyyyyyyyyyyyyikkkk
hhRqaaaaaaaaaaaaaaaaaaaaaaaaaaaaaaaaaaaaaaaaaaaaaaaaaaaaaaaaaaaaaaaaaaaaaaaaaaaaaaaaaqRhhh
qqqqaaaaaaaaaaaaaaaaaaaaaaaaaaaaaaaaaaaaaaaaaaaaaaaaaaaaaaaaaaaaaaaaaaaaaaaaaaaaaaaaaqqqqq
aaaSaaaaaaaaaaaaaaaaaaaaaaaaaaaaaaaaaaaaaaaaaaaaaaaaaaaaaaaaaaaaaaaaaaaaaaaaaaaaaaaaaSaaaa
aaSSaaaaaaaaaaaaaaaaaaaaaaaaaaaaaaaaaaaaaaaaaaaaaaaaaaaaaaaaaaaaaaaaaaaaaaaaaaaaaaaaSSaaaa
aSSaaaaaaaaaaaaaaaaaaaaaaaaaaaaaaaaaaaaaaaaaaaaaaaaaaaaaaaaaaaaaaaaaaaaaaaaaaaaaaaaaSaaaaa
aSSaaaaaaaaaaaaaaaaaaaaaaaaaaaaaaaaaaaaaaaaaaaaaaaaaaaaaaaaaaaaaaaaaaaaaaaaaaaaaaaaSSaaaaa
aSaaaaaaaaaaaaaaaaaaaaaaaaaaaaaaaaaaaaaaaaaaaaaaaaaaaaaaaaaaaaaaaaaaaaaaaaaaaaaaaaaaSaaaaa
aSaaaaaaaaaaaaaaaaaaaaaaaaaaaaaaaaaaaaaaaaaaaaaaaaaaaaaaaaaaaaaaaaaaaaaaaaaaaaaaaaaaSaaaaa
aSSaaaaaaaaaaaaaaaaaaaaaaaaaaaaaaaaaaaaaaaaaaaaaaaaaaaaaaaaaaaaaaaaaaaaaaaaaaaaaaaaaSSaaaa
aaSaaaaaaaaaaaaaaaaaaaaaaaaaaaaaaaaaaaaaaaaaaaaaaaaaaaaaaaaaaaaaaaaaaaaaaaaaaaaaaaaaaSaaaa
aSSaaaaaaaaaaaaaaaaaaaaaaaaaaaaaaaaaaaaaaaaaaaaaaaaaaaaaaaaaaaaaaaaaaaaaaaaaaaaaaaaaaSaaaa
aSaaaaaaaaaaaaaaaaaaaaaaaaaaaaaaaaaaaaaaaaaaaaaaaaaaaaaaaaaaaaaaaaaaaaaaaaaaaaaaaaaaSSaaaa
aSSaaaaaaaaaaaaaaaaaaaaaaaaaaaaaaaaaaaaaaaaaaaaaaaaaaaaaaaaaaaaaaaaaaaaaaaaaaaaaaaaaSaaaaa
aaSaaaaaaaaaaaaaaaaaaaaaaaaaaaaaaaaaaaaaaaaaaaaaaaaaaaaaaaaaaaaaaaaaaaaaaaaaaaaaaaaaSaaaaa
aSSaaaaaaaaaaaaaaaaaaaaaaaaaaaaaaaaaaaaaaaaaaaaaaaaaaaaaaaaaaaaaaaaaaaaaaaaaaaaaaaaSSaaaaa
SSaaaaaaaaaaaaaaaaaaaaaaaaaaaaaaaaaaaaaaaaaaaaaaaaaaaaaaaaaaaaaaaaaaaaaaaaSSSSSSaaSSaaaaaa
SaaaaaaaaaaaaaaaaaaaaaaaaaaaaaaaaaaaaaaaaaaaaaaaaaaaaaaaaaaaaaaaaSSSSaaaSSSaaaaSSSSaaaaaaa
SSaaaaaaaaaaaaaaaaaaaaaaaaaaaaaaaaaaaaaaaaaaaaaaaaaaaaaaSSSSSSSSSSaaSSSSSaaaaaaaaaaaaaaaaa
aSaaaaaaaaaaaaaaaaaaaaaaaaaaaaaaaaaaaaaaaaaaaaaaaaaaaSSSSaaaaaaaaaaaaaaaaaaaaaaaaaaaaaaaaa
aSSaaaaaaaaaaaaaaaaaaaaaaaaaaaaaaaaaaaaaaaaaaaaaaaaaSSaaaaaaaaaaaaaaaaaaaaaaaaaaaaaaaaaaaa
aaSSaaaaaaaaaaaSSSSaaaaaaaaaaaaaaaaaaaaaaaaaaaaaaaaaaaaaaaaaaaaaaaaaaaaaaaaaaaaaaaaaaaaaaa
aaaSaaSSSSaSSSSSaaaaaaaaaaaaaaaaaaaaaaaaaaaaaaaaaaaaaaaaaaaaaaaaaaaaaaaaaaaaaaaaaaaaaaaaaa
aaaSSSSaaSSSaaaaaaaaaaaaaaaaaaaaaaaaaaaaaaaaaaaaaaaaaaaaaaaaaaaaaaaaaaaaaaaaaaaaaaaaaaaaaa
"}
(1,1,2) = {"
aSSSSSSSSSSSSaaaaaaaaaaaaaaaaaaaaaaaaaaaaaaaaaaaaaaaaaaaaaaaaaaaaaaaaaaaaaaaaaaaaaaaaaaaaa
aSaaaaaaaaaaSSaaaaaaaaSSSSSaaaSSSSaaaaaaaaaaaaaaaaaaaaaaaaaaaaaaaaaaaaSSSaaaaaaaaaaaaaaaaa
aSaaaaaaaaaaaSaaaaaSSSSaaaSSSSSaaSSSaaaaaaaaaaaaSSSaSSSaaSSSaaSSSSaSSSSaSSSSSaaaaaaaaaaaaa
aSSaaaaaaaaaaSaaaSSSaaaaaaaaaaaaaaaSSaaaaSSSaaSSSaSSSaSSSSaSSSSaaSSSaaaaaaaaSSaaaaaaaaaaaa
aaSaaaaaaaaaaSSSSSaaaaaaaaaaaaaaaaaaSSaaSSaSSSSaaaaaaaaaaaaaaaaaaaaaaaaaaaaaaSSSaaaaaaaaaa
aaSaaaaaaaaaaaaaaaaaaaaaaaaaaaaaaaaaNaaabaaaNbKaaaaaaaaKKaaUaaaNKaaUaaaaaaaaaUaSaaaaaaaaaa
aaSSaaaaaaaaaaaaaaaaaaaaaaaaaaaaaaaaUbbbaaUaaaaaaUaaKaaaaaKeaaaMaaabaaabafaaaaaSSaaaaaaaaa
aaaSaaaaaaaaaaaaaaaaaaaaaaaaaaaaaaaaaKaaaaaKeaaaMaaKeaUaaKaaaaNaaKabaaaaVaaUaaabSaaaaaaaaa
aaaSaaaaaaaaaaaaaaaaaaaaaaaaaaaaaaaaKeaUaaKaaaaNaaaaaaaaEaaaaaaaaKaaUaUaaaabaaabSaaaaaaaaa
aaSSaaaaaaaaaaaaaaaaaaaaaaaaaaaaaaaaaaaaaaaaaaaaaaeKabaaaaaaUaeaaaaeaaaaaKabaaaaSaaaaaaaaa
aaSaaaaaaaaaaaaaaaaaaaaaaaaaaaaaaaaeKabaaaaaaUaeaaaaabaaNaaaaKKaNaaaIaNaaKaaUaUaSSaaaaaaaa
aaSaaaaaaaaaaaaaaaaaaaaaaaaaaaaaaaaaaabaaNaaaaKKaNaaaaUaUIaaIaaaaabaaIaaaaaeaaaaaSaaaaaaaa
aaSaaaaaaaaaaaaaaaaaaaaaaaaaaaaaaaaaaaaUaUIaaIaaaaaaaaaaaafdaabaaaaaeabbNaaaIaNaaSSaaaaaaa
aSSaaaaaaaaaaaaaaaaaaaaaaaaaaaaaaaaaUaaaaaafdaabaaaaaaaaeaaUaaaaabaaUaabaabaaIaaaaSaaaaaaa
aSaaaaaaaaaaaaaaaaaaaaaaaaaaaaaaaaaKaaaaaKeaaaaaaaaaaaUaaaaaaeaUaaaaaaabaaaaeabbaSSaaaaaaa
aSSaaaaaaaaaaaaaaaaaaaaaaaaaaaaaaaaeaUaaKaaaaNeaUaaaaaaaaaKKabaaaaKaaaaaabaaUaabaSaaaaaaaa
aaSaaaNaaabaaaNbKaaaaaaaaKKaaUaaaNKaaaaaaaaaaabaaaaaaaaeabaKaaaaeaaKKaaUaaaaaaabSSaaaaaaaa
aaSSaaUbbbaaUaaaaaaUaaKaaaaaKeaaaMaabaaaaaaUaeaaaeaaaINaaaaaaaUaaaaaaKaKaaKaaaaaSaaaaaaaaa
aaaSaaaKaaaaaKeaaaMaaKeaUaaKaaaaNaaabaaNaaaaKKaUaaaaaaaNUaaaeaUaaUaaaaaaeaaKKaaUaaaaaaaaaa
aaaSaaKeaUaaKaaaaNaaaaaaaaEaaaaaaaaaaUaUIaaIaaaUaaaaaKaIaabaafaIaaaaeaaaaaaaaKaKSaaaaaaaaa
aaSSaaaaaaaaaaaaaaaaeKabaaaaaaUaeaaaaaaaafdaabfaIaaaKadaaaaaaadaaabaaaaaaUaaaaaaSSSaaaaaaa
aaSaaeKabaaaaaaUaeaaaaabaaNaaaaKKaNaaaaeaaUaaaadaaaaaafaUaaUUaaabaaaaUUaaaaaeaaaaaSaaaaaaa
aaSSaaaabaaNaaaaKKaNaaaaUaUIaaIaaaaaaUaaaaaaeaaaabaaaaaaaaeaaaaIaKaKaaUaaabaaaaaaaSSaaaaaa
aaaSaaaaaUaUIaaIaaaaaaaaaaaafdaabaaaaaaaaKKabaaaIaaaaaUUaaaaNaKKaaaeaIUabaaaaUUaaaaSaaaaaa
aaaSaaUaaaaaafdaabaaaaaaaaeaaUaaaaaaaaeabaKaaaaKKaaaaKeUaaKaaaaaUaaMaaaaaKaKaaUaaaaSaaaaaa
aaaSSKaaaaaKeaaaaaaaaaaaUaaaaaaeaUaaINaaaaaaaUaaaUaaaaaaaKaaIaeaaaNaxfaaaaaeaIUaaaSSaaaaaa
aaaaSeaUaaKaaaaNeaUaaaaaaaaaKKabaaaaaaNUaaaeaUaeaaaaaKaaaKaaKaUUaaaaKaaaUaaMaaaaaaSaaaaaaa
aaaSSaaaaaaaaaaabaaaaaaaaeabaKaaaaeaKaIaabaafaaUUaaaaKaaaaaaaaaaaKaaIaeaaaNaxfaaaSSaaaaaaa
aaaSaabaaaaaaUaeaaaeaaaINaaaaaaaUaaaaaaaaaaaaaaaaaaaaaaaaaaaaKaaaKaaKaUUaaaaKaaaaSaaaaaaaa
aaSSaabaaNaaaaKKaUaaaaaaaNUaaaeaUaaUaaaaaaeaaKKaaUaaaaaaaaaaaaaaaaaaaaaaaaaaaaaaaSaaaaaaaa
aaSaaaaUaUIaaIaaaUaaaaaKaIaabaafaIaaaaeaaaaaaaaKaKaaaaaaaaaaaaaaaaaaaaaaaaaaaaaaaSaaaaaaaa
aaSSaaaaaaafdaabfaIaaaKadaaaaaaadaaabaaaaaaUaaaaaaaaaaaaaaaaaaaaaaaaaaaaaaaaaaaaaSSaaaaaaa
aaaSSaaaaeaaUaaaadaaaaaafaUaaUUaaabaaaaUUaaaaaeaaaaaaaaaaaaaaaaaaaaaaaaaaaaaaaaaaaSaaaaaaa
aaaaSaaUaaaaaaeaaaabaaaaaaaaeaaaaIaKaKaaUaaabaaaaaaaaaaaaaaaaaaaaaaaaaaaaaaaaaaaaaSaaaaaaa
aaaSSaaaaaaKKabaaaIaaaaaUUaaaaNaKKaaaeaIUabaaaaUUaaaaaaaaaaaaaaaaaaaaaaaaaaaaaaaaaSaaaaaaa
aaaSaaaaeabaKaaaaKKaaaaKeUaaKaaaaaUaaMaaaaaKaKaaUaaaaaaaaaaaaaaaaaaaaaaaaaaaaaaaaSSaaaaaaa
aaSSaaINaaaaaaaUaaaUaaaaaaaKaaIaeaaaNaxfaaaaaeaIUaaaaaaaaaaaaaaaaaaaaaaaaaaaaaaaaSaaaaaaaa
aaSaaaaaNUaaaeaUaeaaaaaKaaaKaaKaUUaaaaKaaaUaaMaaaaaaaaaaaaaaaaaaaaaaaaaaaaaaaaaaaSSaaaaaaa
aSSaaaKaIaabaafaaUUaaaaKaaaaaaaaaaaKaaIaeaaaNaxfaaaaaaaaaaaaaaaaaaaaaaaaaaaaaaaaaaSSaaaaaa
aSaaaaaaaaaaaaaaaaaaaaaaaaaaaaaKaaaKaaKaUUaaaaKaaaaaaaaaaaaaaaaaaaaaaaaaaaaaaaaaaaSaaaaaaa
aSaaaaaaaaaaaaaaaaaaaaaaaaaaaaaaaaaaaaaaaaaaaaaaaaaaaaaaaaaaaaaaaaaaaaaaaaaaaaaaaaSaaaaaaa
aSaaaaaaaaaaaaaaaaaaaaaaaaaaaaaaaaaaaaaaaaaaaaaaaaaaaaaaaaaaaaaaaaaaaaaaaaaaaaaaaaSaaaaaaa
aSSaaaaaaaaaaaaaaaaaaaaaaaaaaaaaaaaaaaaaaaaaaaaaaaaaaaaaaaaaaaaaaaaaaaaaaaaaaaaaaaSaaaaaaa
aaSSaaaaaaaaaaaaaaaaaaaaaaaaaaaaaaaaaaaaaaaaaaaaaaaaaaaaaaaaaaaaaaaaaaaaaaaaaaaaaaSSaaaaaa
aaaSqsssssssssssssssssssssssssssssssssssssssssssssssssssssssssssssssssssssssssssssqSaaaaaa
aaaSaaaaaaaaaaaaaaaaaaaaaaaaaaaaaaaaaaaaaaaaaaaaaaaaaaaaaaaaaaaaaaaaaaaaaaaaaaaaaaaSSaaaaa
aaaSSaaaaaaaaaaaaaaaaaaaaaaaaaaaaaaaaaaaaaaaaaaaaaaaaaaaaaaaaaaaaaaaaaaaaaaaaaaaaaaaSaaaaa
aaSSaaaaaaaaaaaaaaaaaaaaaaaaaaaaaaaaaaaaaaaaaaaaaaaaaaaaaaaaaaaaaaaaaaaaaaaaaaaaaaaaSaaaaa
aaSaaaaaaaaaaaaaaaaaaaaaaaaaaaaaaaaaaaaaaaaaaaaaaaaaaaaaaaaaaaaaaaaaaaaaaaaaaaaaaaaaSSaaaa
aaSSaaaaaaaaaaaaaaaaaaaaaaaaaaaaaaaaaaaaaaaaaaaaaaaaaaaaaaaaaaaaaaaaaaaaaaaaaaaaaaaaaSaaaa
aaaSaaaaaaaaaaaaaaaaaaaaaaaaaaaaaaaaaaaaaaaaaaaaaaaaaaaaaaaaaaaaaaaaaaaaaaaaaaaaaaaaaSaaaa
qqqqaaaaaaaaaaaaaaaaaaaaaaaaaaaaaaaaaaaaaaaaaaaaaaaaaaaaaaaaaaaaaaaaaaaaaaaaaaaaaaaaaqqqqq
hJAqaaaaaaaaaaaaaaaaaaaaaaaaaaaaaaaaaaaaaaaaaaaaaaaaaaaaaaaaaaaaaaaaaaaaaaaaaaaaaaaaaqAhJJ
mmmmZZZZZZZZZZZZZZZZZZZZZZZZZZZZZZZZZZZZZZZZZZZZZZZZZZZZZZZZZZZZZZZZZZZZZZZZZZZZZZZZZzmmmm
tttttttttttttttttttttttttttttttttttttttttttttttttttttttttttttttttttttttttttttttttttttttttt
tttttttttttttttttttttttttttttttttttttttttttttttttttttttttttttttttttttttttttttttttttttttttt
kkkkyyyyyyyyyyyyyyyyyyyyyyyyyyyyyyyyyyyyyyyyyyyyyyyyyyyyyyyyyyyyyyyyyyyyyyyyyyyyyyyyyikkkk
hhRqaaaaaaaaaaaaaaaaaaaaaaaaaaaaaaaaaaaaaaaaaaaaaaaaaaaaaaaaaaaaaaaaaaaaaaaaaaaaaaaaaqRhhh
qqqqaaaaaaaaaaaaaaaaaaaaaaaaaaaaaaaaaaaaaaaaaaaaaaaaaaaaaaaaaaaaaaaaaaaaaaaaaaaaaaaaaqqqqq
aaaSaaaaaaaaaaaaaaaaaaaaaaaaaaaaaaaaaaaaaaaaaaaaaaaaaaaaaaaaaaaaaaaaaaaaaaaaaaaaaaaaaSaaaa
aaSSaaaaaaaaaaaaaaaaaaaaaaaaaaaaaaaaaaaaaaaaaaaaaaaaaaaaaaaaaaaaaaaaaaaaaaaaaaaaaaaaSSaaaa
aSSaaaaaaaaaaaaaaaaaaaaaaaaaaaaaaaaaaaaaaaaaaaaaaaaaaaaaaaaaaaaaaaaaaaaaaaaaaaaaaaaaSaaaaa
aSSaaaaaaaaaaaaaaaaaaaaaaaaaaaaaaaaaaaaaaaaaaaaaaaaaaaaaaaaaaaaaaaaaaaaaaaaaaaaaaaaSSaaaaa
aSaaaaaaaaaaaaaaaaaaaaaaaaaaaaaaaaaaaaaaaaaaaaaaaaaaaaaaaaaaaaaaaaaaaaaaaaaaaaaaaaaaSaaaaa
aSaaaaaaaaaaaaaaaaaaaaaaaaaaaaaaaaaaaaaaaaaaaaaaaaaaaaaaaaaaaaaaaaaaaaaaaaaaaaaaaaaaSaaaaa
aSSaaaaaaaaaaaaaaaaaaaaaaaaaaaaaaaaaaaaaaaaaaaaaaaaaaaaaaaaaaaaaaaaaaaaaaaaaaaaaaaaaSSaaaa
aaSaaaaaaaaaaaaaaaaaaaaaaaaaaaaaaaaaaaaaaaaaaaaaaaaaaaaaaaaaaaaaaaaaaaaaaaaaaaaaaaaaaSaaaa
aSSaaaaaaaaaaaaaaaaaaaaaaaaaaaaaaaaaaaaaaaaaaaaaaaaaaaaaaaaaaaaaaaaaaaaaaaaaaaaaaaaaaSaaaa
aSaaaaaaaaaaaaaaaaaaaaaaaaaaaaaaaaaaaaaaaaaaaaaaaaaaaaaaaaaaaaaaaaaaaaaaaaaaaaaaaaaaSSaaaa
aSSaaaaaaaaaaaaaaaaaaaaaaaaaaaaaaaaaaaaaaaaaaaaaaaaaaaaaaaaaaaaaaaaaaaaaaaaaaaaaaaaaSaaaaa
aaSaaaaaaaaaaaaaaaaaaaaaaaaaaaaaaaaaaaaaaaaaaaaaaaaaaaaaaaaaaaaaaaaaaaaaaaaaaaaaaaaaSaaaaa
aSSaaaaaaaaaaaaaaaaaaaaaaaaaaaaaaaaaaaaaaaaaaaaaaaaaaaaaaaaaaaaaaaaaaaaaaaaaaaaaaaaSSaaaaa
SSaaaaaaaaaaaaaaaaaaaaaaaaaaaaaaaaaaaaaaaaaaaaaaaaaaaaaaaaaaaaaaaaaaaaaaaaSSSSSSaaSSaaaaaa
SaaaaaaaaaaaaaaaaaaaaaaaaaaaaaaaaaaaaaaaaaaaaaaaaaaaaaaaaaaaaaaaaSSSSaaaSSSaaaaSSSSaaaaaaa
SSaaaaaaaaaaaaaaaaaaaaaaaaaaaaaaaaaaaaaaaaaaaaaaaaaaaaaaSSSSSSSSSSaaSSSSSaaaaaaaaaaaaaaaaa
aSaaaaaaaaaaaaaaaaaaaaaaaaaaaaaaaaaaaaaaaaaaaaaaaaaaaSSSSaaaaaaaaaaaaaaaaaaaaaaaaaaaaaaaaa
aSSaaaaaaaaaaaaaaaaaaaaaaaaaaaaaaaaaaaaaaaaaaaaaaaaaSSaaaaaaaaaaaaaaaaaaaaaaaaaaaaaaaaaaaa
aaSSaaaaaaaaaaaSSSSaaaaaaaaaaaaaaaaaaaaaaaaaaaaaaaaaaaaaaaaaaaaaaaaaaaaaaaaaaaaaaaaaaaaaaa
aaaSaaSSSSaSSSSSaaaaaaaaaaaaaaaaaaaaaaaaaaaaaaaaaaaaaaaaaaaaaaaaaaaaaaaaaaaaaaaaaaaaaaaaaa
aaaSSSSaaSSSaaaaaaaaaaaaaaaaaaaaaaaaaaaaaaaaaaaaaaaaaaaaaaaaaaaaaaaaaaaaaaaaaaaaaaaaaaaaaa
"}
(1,1,3) = {"
rrrrrrrrrrrrrrrrrrrrrrrrrrrrrrrrrrrrrrrrrrrrrrrrrrrrrrrrrrrrrrrrrrrrrrrrrrrrrrrrrrrrrrrrrr
rrrrrrrrrrrrrrrrrrrrrrrrrrrrrrrrrrrrrrrrrrrrrrrrrrrrrrrrrrrrrrrrrrrrrrrrrrrrrrrrrrrrrrrrrr
rrrrrrrrrrrrrrrrrrrrrrrrrrrrrrrrrrrrrrrrrrrrrrrrrrrrrrrrrrrrrrrrrrrrrrrrrrrrrrrrrrrrrrrrrr
rrrrrrrrrrrrrrrrrrrrrrrrrrrrrrrrrrrrrrrrrrrrrrrrrrrrrrrrrrrrrrrrrrrrrrrrrrrrrrrrrrrrrrrrrr
rrrrrrrrrrrrrrrrrrrrrrrrrrrrrrrrrrrrrrrrrrrrrrrrrrrrrrrrrrrrrrrrrrrrrrrrrrrrrrrrrrrrrrrrrr
rrrrrrrrrrrrrrrrrrrrrrrrrrrrrrrrrrrrrrrrrrrrrrrrrrrrrrrrrrrrrrrrrrrrrrrrrrrrrrrrrrrrrrrrrr
rrrrrrrrrrrrrrrrrrrrrrrrrrrrrrrrrrrrrrrrrrrrrrrrrrrrrrrrrrrrrrrrrrrrrrrrrrrrrrrrrrrrrrrrrr
rrrrrrrrrrrrrrrrrrrrrrrrrrrrrrrrrrrrrrrrrrrrrrrrrrrrrrrrrrrrrrrrrrrrrrrrrrrrrrrrrrrrrrrrrr
rrrrrrrrrrrrrrrrrrrrrrrrrrrrrrrrrrrrrrrrrrrrrrrrrrrrrrrrrrrrrrrrrrrrrrrrrrrrrrrrrrrrrrrrrr
rrrrrrrrrrrrrrrrrrrrrrrrrrrrrrrrrrrrrrrrrrrrrrrrrrrrrrrrrrrrrrrrrrrrrrrrrrrrrrrrrrrrrrrrrr
rrrrrrrrrrrrrrrrrrrrrrrrrrrrrrrrrrrrrrrrrrrrrrrrrrrrrrrrrrrrrrrrrrrrrrrrrrrrrrrrrrrrrrrrrr
rrrrrrrrrrrrrrrrrrrrrrrrrrrrrrrrrrrrrrrrrrrrrrrrrrrrrrrrrrrrrrrrrrrrrrrrrrrrrrrrrrrrrrrrrr
rrrrrrrrrrrrrrrrrrrrrrrrrrrrrrrrrrrrrrrrrrrrrrrrrrrrrrrrrrrrrrrrrrrrrrrrrrrrrrrrrrrrrrrrrr
rrrrrrrrrrrrrrrrrrrrrrrrrrrrrrrrrrrrrrrrrrrrrrrrrrrrrrrrrrrrrrrrrrrrrrrrrrrrrrrrrrrrrrrrrr
rrrrrrrrrrrrrrrrrrrrrrrrrrrrrrrrrrrrrrrrrrrrrrrrrrrrrrrrrrrrrrrrrrrrrrrrrrrrrrrrrrrrrrrrrr
rrrrrrrrrrrrrrrrrrrrrrrrrrrrrrrrrrrrrrrrrrrrrrrrrrrrrrrrrrrrrrrrrrrrrrrrrrrrrrrrrrrrrrrrrr
rrrrrrrrrrrrrrrrrrrrrrrrrrrrrrrrrrrrrrrrrrrrrrrrrrrrrrrrrrrrrrrrrrrrrrrrrrrrrrrrrrrrrrrrrr
rrrrrrrrrrrrrrrrrrrrrrrrrrrrrrrrrrrrrrrrrrrrrrrrrrrrrrrrrrrrrrrrrrrrrrrrrrrrrrrrrrrrrrrrrr
rrrrrrrrrrrrrrrrrrrrrrrrrrrrrrrrrrrrrrrrrrrrrrrrrrrrrrrrrrrrrrrrrrrrrrrrrrrrrrrrrrrrrrrrrr
rrrrrrrrrrrrrrrrrrrrrrrrrrrrrrrrrrrrrrrrrrrrrrrrrrrrrrrrrrrrrrrrrrrrrrrrrrrrrrrrrrrrrrrrrr
rrrrrrrrrrrrrrrrrrrrrrrrrrrrrrrrrrrrrrrrrrrrrrrrrrrrrrrrrrrrrrrrrrrrrrrrrrrrrrrrrrrrrrrrrr
rrrrrrrrrrrrrrrrrrrrrrrrrrrrrrrrrrrrrrrrrrrrrrrrrrrrrrrrrrrrrrrrrrrrrrrrrrrrrrrrrrrrrrrrrr
rrrrrrrrrrrrrrrrrrrrrrrrrrrrrrrrrrrrrrrrrrrrrrrrrrrrrrrrrrrrrrrrrrrrrrrrrrrrrrrrrrrrrrrrrr
rrrrrrrrrrrrrrrrrrrrrrrrrrrrrrrrrrrrrrrrrrrrrrrrrrrrrrrrrrrrrrrrrrrrrrrrrrrrrrrrrrrrrrrrrr
rrrrrrrrrrrrrrrrrrrrrrrrrrrrrrrrrrrrrrrrrrrrrrrrrrrrrrrrrrrrrrrrrrrrrrrrrrrrrrrrrrrrrrrrrr
rrrrrrrrrrrrrrrrrrrrrrrrrrrrrrrrrrrrrrrrrrrrrrrrrrrrrrrrrrrrrrrrrrrrrrrrrrrrrrrrrrrrrrrrrr
rrrrrrrrrrrrrrrrrrrrrrrrrrrrrrrrrrrrrrrrrrrrrrrrrrrrrrrrrrrrrrrrrrrrrrrrrrrrrrrrrrrrrrrrrr
rrrrrrrrrrrrrrrrrrrrrrrrrrrrrrrrrrrrrrrrrrrrrrrrrrrrrrrrrrrrrrrrrrrrrrrrrrrrrrrrrrrrrrrrrr
rrrrrrrrrrrrrrrrrrrrrrrrrrrrrrrrrrrrrrrrrrrrrrrrrrrrrrrrrrrrrrrrrrrrrrrrrrrrrrrrrrrrrrrrrr
rrrrrrrrrrrrrrrrrrrrrrrrrrrrrrrrrrrrrrrrrrrrrrrrrrrrrrrrrrrrrrrrrrrrrrrrrrrrrrrrrrrrrrrrrr
rrrrrrrrrrrrrrrrrrrrrrrrrrrrrrrrrrrrrrrrrrrrrrrrrrrrrrrrrrrrrrrrrrrrrrrrrrrrrrrrrrrrrrrrrr
rrrrrrrrrrrrrrrrrrrrrrrrrrrrrrrrrrrrrrrrrrrrrrrrrrrrrrrrrrrrrrrrrrrrrrrrrrrrrrrrrrrrrrrrrr
rrrrrrrrrrrrrrrrrrrrrrrrrrrrrrrrrrrrrrrrrrrrrrrrrrrrrrrrrrrrrrrrrrrrrrrrrrrrrrrrrrrrrrrrrr
rrrrrrrrrrrrrrrrrrrrrrrrrrrrrrrrrrrrrrrrrrrrrrrrrrrrrrrrrrrrrrrrrrrrrrrrrrrrrrrrrrrrrrrrrr
rrrrrrrrrrrrrrrrrrrrrrrrrrrrrrrrrrrrrrrrrrrrrrrrrrrrrrrrrrrrrrrrrrrrrrrrrrrrrrrrrrrrrrrrrr
rrrrrrrrrrrrrrrrrrrrrrrrrrrrrrrrrrrrrrrrrrrrrrrrrrrrrrrrrrrrrrrrrrrrrrrrrrrrrrrrrrrrrrrrrr
rrrrrrrrrrrrrrrrrrrrrrrrrrrrrrrrrrrrrrrrrrrrrrrrrrrrrrrrrrrrrrrrrrrrrrrrrrrrrrrrrrrrrrrrrr
rrrrrrrrrrrrrrrrrrrrrrrrrrrrrrrrrrrrrrrrrrrrrrrrrrrrrrrrrrrrrrrrrrrrrrrrrrrrrrrrrrrrrrrrrr
rrrrrrrrrrrrrrrrrrrrrrrrrrrrrrrrrrrrrrrrrrrrrrrrrrrrrrrrrrrrrrrrrrrrrrrrrrrrrrrrrrrrrrrrrr
rrrrrrrrrrrrrrrrrrrrrrrrrrrrrrrrrrrrrrrrrrrrrrrrrrrrrrrrrrrrrrrrrrrrrrrrrrrrrrrrrrrrrrrrrr
rrrrrrrrrrrrrrrrrrrrrrrrrrrrrrrrrrrrrrrrrrrrrrrrrrrrrrrrrrrrrrrrrrrrrrrrrrrrrrrrrrrrrrrrrr
rrrrrrrrrrrrrrrrrrrrrrrrrrrrrrrrrrrrrrrrrrrrrrrrrrrrrrrrrrrrrrrrrrrrrrrrrrrrrrrrrrrrrrrrrr
rrrrrrrrrrrrrrrrrrrrrrrrrrrrrrrrrrrrrrrrrrrrrrrrrrrrrrrrrrrrrrrrrrrrrrrrrrrrrrrrrrrrrrrrrr
rrrrrrrrrrrrrrrrrrrrrrrrrrrrrrrrrrrrrrrrrrrrrrrrrrrrrrrrrrrrrrrrrrrrrrrrrrrrrrrrrrrrrrrrrr
rrrrrrrrrrrrrrrrrrrrrrrrrrrrrrrrrrrrrrrrrrrrrrrrrrrrrrrrrrrrrrrrrrrrrrrrrrrrrrrrrrrrrrrrrr
rrrrrrrrrrrrrrrrrrrrrrrrrrrrrrrrrrrrrrrrrrrrrrrrrrrrrrrrrrrrrrrrrrrrrrrrrrrrrrrrrrrrrrrrrr
rrrrrrrrrrrrrrrrrrrrrrrrrrrrrrrrrrrrrrrrrrrrrrrrrrrrrrrrrrrrrrrrrrrrrrrrrrrrrrrrrrrrrrrrrr
rrrrrrrrrrrrrrrrrrrrrrrrrrrrrrrrrrrrrrrrrrrrrrrrrrrrrrrrrrrrrrrrrrrrrrrrrrrrrrrrrrrrrrrrrr
rrrrrrrrrrrrrrrrrrrrrrrrrrrrrrrrrrrrrrrrrrrrrrrrrrrrrrrrrrrrrrrrrrrrrrrrrrrrrrrrrrrrrrrrrr
rrrrrrrrrrrrrrrrrrrrrrrrrrrrrrrrrrrrrrrrrrrrrrrrrrrrrrrrrrrrrrrrrrrrrrrrrrrrrrrrrrrrrrrrrr
rrrrrrrrrrrrrrrrrrrrrrrrrrrrrrrrrrrrrrrrrrrrrrrrrrrrrrrrrrrrrrrrrrrrrrrrrrrrrrrrrrrrrrrrrr
rrrrrrrrrrrrrrrrrrrrrrrrrrrrrrrrrrrrrrrrrrrrrrrrrrrrrrrrrrrrrrrrrrrrrrrrrrrrrrrrrrrrrrrrrr
rrrrrrrrrrrrrrrrrrrrrrrrrrrrrrrrrrrrrrrrrrrrrrrrrrrrrrrrrrrrrrrrrrrrrrrrrrrrrrrrrrrrrrrrrr
rrrrrrrrrrrrrrrrrrrrrrrrrrrrrrrrrrrrrrrrrrrrrrrrrrrrrrrrrrrrrrrrrrrrrrrrrrrrrrrrrrrrrrrrrr
rrrrrrrrrrrrrrrrrrrrrrrrrrrrrrrrrrrrrrrrrrrrrrrrrrrrrrrrrrrrrrrrrrrrrrrrrrrrrrrrrrrrrrrrrr
rrrrrrrrrrrrrrrrrrrrrrrrrrrrrrrrrrrrrrrrrrrrrrrrrrrrrrrrrrrrrrrrrrrrrrrrrrrrrrrrrrrrrrrrrr
rrrrrrrrrrrrrrrrrrrrrrrrrrrrrrrrrrrrrrrrrrrrrrrrrrrrrrrrrrrrrrrrrrrrrrrrrrrrrrrrrrrrrrrrrr
rrrrrrrrrrrrrrrrrrrrrrrrrrrrrrrrrrrrrrrrrrrrrrrrrrrrrrrrrrrrrrrrrrrrrrrrrrrrrrrrrrrrrrrrrr
rrrrrrrrrrrrrrrrrrrrrrrrrrrrrrrrrrrrrrrrrrrrrrrrrrrrrrrrrrrrrrrrrrrrrrrrrrrrrrrrrrrrrrrrrr
rrrrrrrrrrrrrrrrrrrrrrrrrrrrrrrrrrrrrrrrrrrrrrrrrrrrrrrrrrrrrrrrrrrrrrrrrrrrrrrrrrrrrrrrrr
rrrrrrrrrrrrrrrrrrrrrrrrrrrrrrrrrrrrrrrrrrrrrrrrrrrrrrrrrrrrrrrrrrrrrrrrrrrrrrrrrrrrrrrrrr
rrrrrrrrrrrrrrrrrrrrrrrrrrrrrrrrrrrrrrrrrrrrrrrrrrrrrrrrrrrrrrrrrrrrrrrrrrrrrrrrrrrrrrrrrr
rrrrrrrrrrrrrrrrrrrrrrrrrrrrrrrrrrrrrrrrrrrrrrrrrrrrrrrrrrrrrrrrrrrrrrrrrrrrrrrrrrrrrrrrrr
rrrrrrrrrrrrrrrrrrrrrrrrrrrrrrrrrrrrrrrrrrrrrrrrrrrrrrrrrrrrrrrrrrrrrrrrrrrrrrrrrrrrrrrrrr
rrrrrrrrrrrrrrrrrrrrrrrrrrrrrrrrrrrrrrrrrrrrrrrrrrrrrrrrrrrrrrrrrrrrrrrrrrrrrrrrrrrrrrrrrr
rrrrrrrrrrrrrrrrrrrrrrrrrrrrrrrrrrrrrrrrrrrrrrrrrrrrrrrrrrrrrrrrrrrrrrrrrrrrrrrrrrrrrrrrrr
rrrrrrrrrrrrrrrrrrrrrrrrrrrrrrrrrrrrrrrrrrrrrrrrrrrrrrrrrrrrrrrrrrrrrrrrrrrrrrrrrrrrrrrrrr
rrrrrrrrrrrrrrrrrrrrrrrrrrrrrrrrrrrrrrrrrrrrrrrrrrrrrrrrrrrrrrrrrrrrrrrrrrrrrrrrrrrrrrrrrr
rrrrrrrrrrrrrrrrrrrrrrrrrrrrrrrrrrrrrrrrrrrrrrrrrrrrrrrrrrrrrrrrrrrrrrrrrrrrrrrrrrrrrrrrrr
rrrrrrrrrrrrrrrrrrrrrrrrrrrrrrrrrrrrrrrrrrrrrrrrrrrrrrrrrrrrrrrrrrrrrrrrrrrrrrrrrrrrrrrrrr
rrrrrrrrrrrrrrrrrrrrrrrrrrrrrrrrrrrrrrrrrrrrrrrrrrrrrrrrrrrrrrrrrrrrrrrrrrrrrrrrrrrrrrrrrr
rrrrrrrrrrrrrrrrrrrrrrrrrrrrrrrrrrrrrrrrrrrrrrrrrrrrrrrrrrrrrrrrrrrrrrrrrrrrrrrrrrrrrrrrrr
rrrrrrrrrrrrrrrrrrrrrrrrrrrrrrrrrrrrrrrrrrrrrrrrrrrrrrrrrrrrrrrrrrrrrrrrrrrrrrrrrrrrrrrrrr
rrrrrrrrrrrrrrrrrrrrrrrrrrrrrrrrrrrrrrrrrrrrrrrrrrrrrrrrrrrrrrrrrrrrrrrrrrrrrrrrrrrrrrrrrr
rrrrrrrrrrrrrrrrrrrrrrrrrrrrrrrrrrrrrrrrrrrrrrrrrrrrrrrrrrrrrrrrrrrrrrrrrrrrrrrrrrrrrrrrrr
rrrrrrrrrrrrrrrrrrrrrrrrrrrrrrrrrrrrrrrrrrrrrrrrrrrrrrrrrrrrrrrrrrrrrrrrrrrrrrrrrrrrrrrrrr
rrrrrrrrrrrrrrrrrrrrrrrrrrrrrrrrrrrrrrrrrrrrrrrrrrrrrrrrrrrrrrrrrrrrrrrrrrrrrrrrrrrrrrrrrr
rrrrrrrrrrrrrrrrrrrrrrrrrrrrrrrrrrrrrrrrrrrrrrrrrrrrrrrrrrrrrrrrrrrrrrrrrrrrrrrrrrrrrrrrrr
rrrrrrrrrrrrrrrrrrrrrrrrrrrrrrrrrrrrrrrrrrrrrrrrrrrrrrrrrrrrrrrrrrrrrrrrrrrrrrrrrrrrrrrrrr
rrrrrrrrrrrrrrrrrrrrrrrrrrrrrrrrrrrrrrrrrrrrrrrrrrrrrrrrrrrrrrrrrrrrrrrrrrrrrrrrrrrrrrrrrr
"}
